111111
100101
110001
1100N1
111111
